

--------------------
|                  |
|                  |
|                  |
|                  |
|                  |
|                  |
|    |------|      |
|                  |
|                  |
|                  |
|                  |
|                  |
|                  |
|                  |
|                  |
|                  |
|                  |
|                  |
|                  |
|                  |
--------------------
