

--------------------
|                  |
|                  |
|                  |
|                  |
|                  |
|                  |
|    /------/      |
|                  |
|                  |
|                  |
|                  |
|                  |
|                  |
|                  |
|                  |
|                  |
|                  |
|                  |
|                  |
|                  |
--------------------
