

--------------------
|                  |
|                  |
|-------/          |
|                  |
|                  |
|                  |
|                  |
|                  |
|              /---|
|                  |
|                  |
|                  |
|                  |
|                  |
|                  |
|         _        |
|         |        |
|         |        |
|         |        |
|         |        |
--------------------