

--------------------
|            |     |
|            |     |
|            |     |
|            |     |
|            |     |
|            _     |
|                  |
|                  |
|--------/         |
|                  |
|                  |
|                  |
|                  |
|                  |
|                  |
|                  |
|                  |
|                  |
|                  |
|                  |
--------------------